o_++___+_
_#_#_#_#_
+_++___++
_#_#_#_#_
__++___+_
_#_#_#_#_
__+++_++o