________
__o_____
+_____o+
________
___+____