o___o__+_
_#_#_#_#_
+_o____++
_#_#_#_#_
_______+_
_#_#_#_#_
__+++___o